7,6,8,0,6,8
0,0,0,0,0,0
0,1,6,0,0,0
0,9,1,9,0,9
6,0,0,5,6,7
0,9,0,9,0,9
1,1,1,1,1,1
1,1,1,1,1,1
