7,6,8,7,6,8
0,0,0,0,0,0
5,0,6,0,7,6
0,9,0,9,0,9
6,8,0,5,6,7
0,9,0,9,0,9
1,1,1,1,1,1
1,1,1,1,1,1
