0,6,0,7,0,8
5,0,0,0,0,5
0,0,9,0,9,0
0,7,0,6,0,8
0,0,0,0,0,0
9,0,9,0,9,0
0,5,0,0,7,0
0,0,0,9,0,0
0,0,0,0,0,0
1,1,1,1,1,1
