8,0,0,0,7
0,0,8,7,0
9,7,0,0,9
7,0,0,0,6
0,0,0,9,0
1,1,1,1,1